#######E##
#      ###
#   # # ##
#  ## # ##
# # # # ##
# # # # ##
# # # # ##
# # # #  #
#######S##